0 4 5 0 0 0 0 4 5 0 0 0 0 4 5 0 
0 4 1 2 2 2 2 1 1 2 2 2 2 1 5 0 
0 4 1 1 1 1 1 1 1 1 1 1 1 1 5 0 
0 4 1 1 1 1 1 1 1 1 1 1 1 1 5 0 
0 4 1 1 1 1 1 1 1 1 1 1 1 1 5 0 
0 4 1 1 1 1 1 1 1 1 1 1 1 1 5 0 
0 4 1 1 1 1 1 1 1 1 1 1 1 1 5 0 
0 4 1 1 1 1 1 1 1 1 1 1 1 1 5 0 
0 4 1 1 1 1 1 1 1 1 1 1 1 1 5 0 
0 4 1 1 1 1 1 1 1 1 1 1 1 1 5 0 
0 6 1 1 3 3 3 3 3 3 3 3 3 3 7 0 
0 0 4 5 0 0 0 0 0 0 0 0 0 0 0 0 