9 8 0 0 9 2 2 2 2 2 2 2 2 2 2 8 
4 5 0 0 6 3 3 3 3 3 3 3 3 3 1 5 
4 5 0 0 0 0 0 0 0 0 0 0 0 0 4 5 
4 5 0 0 0 0 0 0 0 0 0 0 0 0 4 5 
4 5 0 0 0 0 0 0 0 0 0 0 0 0 4 5 
4 5 0 0 0 0 0 0 0 0 0 0 0 0 4 5 
4 5 0 0 0 0 0 0 0 0 0 0 0 0 4 5 
4 5 0 0 0 0 0 0 0 0 0 0 0 0 4 5 
4 5 0 0 0 0 0 0 0 0 0 0 0 0 4 5 
4 5 0 0 0 0 0 0 0 0 0 0 0 0 4 5 
4 1 2 2 2 2 2 2 2 2 2 2 2 2 1 5 
6 3 3 3 3 3 3 3 3 3 3 3 3 3 3 7 